WWWWWWWWWWWWWWWWWWWWWWWWW
W            WW   WWW   W
W        WWW           WW
WWWWW         WW  WWWWWWW
W        WWWWWW  WWWWWWWW
W        WW  WW  WWW  WWW
W                WWW WWWW
W    WWWWWWW            W
WWWWWWWWWWWW            W
WWWW WWWWWWWWW     WWWWWW
WWWWWWWWWWWWWWWWWWWWWWWWW
