WWWWWWWWWWWWWWWWWWWWWWWWW
W            WW   WWW   W
W  WWW   WWW WW        WW
WWWW W   WWW WW  WWWWWWWW
W    W   WWWWWW  WWWWWWWW
W   WW   WW  WW  WWW  WWW
W                WWW WWWW
W    WWWWWWW            W
WWWWWWWWWWWW            W
WWWW WWWWWWWWW     WWWWWW
WWWWWWWWWWWWWWWWWWWWWWWWW
