WWWWWWWWWWWWWWWWWWWWWWWWW
W            WW   WWW   W
W        WWW WW        WW
W        WWW WW  WWWWWWWW
W        WWWWWW  WWWWWWWW
W        WW  WW  WWW  WWW
W                WWW WWWW
W    WWWWWWW            W
WWWWWWWWWWWW            W
WWWW WWWWWWWWW     WWWWWW
WWWWWWWWWWWWWWWWWWWWWWWWW
