WWWWWWWWWWWWWWWWWWWWWWWWW
W           TWW   WWW   W
W        WWWW          WW
WSWWW        TWW  WWWWWWW
W        WWWWWW  WWWWWWWW
W        WW  WW  WWW  WWW
W             T  WWW WWWW
W    WWWWWWW            W
WWWWWWWWWWWW      T     W
WWWW WWWWWWWWW     WWWWWW
WWWWWWWWWWWWWWWWWWWWWWWWW
