WWWWWWWWWWWWWWWWWWWWWWWWW
W T          WW   WWW   W
W        WWW           WW
WSWWW         WW  WWWWWWW
W        WWWWWW  WWWWWWWW
W        WW  WW  WWW  WWW
W                WWW WWWW
W T  WWWWWWW            W
WWWWWWWWWWWW            W
WWWW WWWWWWWWW     WWWWSW
WWWWWWWWWWWWWWWWWWWWWWWSW
WT WWWWWWWWWWWWWWWWWWW  W
WW  WWWWWWW   WWWWWWWW WW
WWW  WWWW   WWWWWWWWW   W
WWW   WWW  WWWWWWWWWWWW W
WWWWW       SSSSSS      W
WWWWWWWWWWWWWWWWWWWWWWWWW