WWWWWWWW
WWWWWWWW
WW    WW
WW  W WW
WW    WW
WWWWWWWW
WWWWWWWW
