WWWWWWWWWWWWWWWWWWW
WWWWWWWWW         W
WWWWWWWWWSWWWWWWWWW
WWWWWWWWWSWWWWWWWWW
WWWWWWWWWSWWWWWWWWW
W                 W
W                 W
W                 W
W                 W
W                 W
W                 W
W                 W
W                 W
WWWWWWWWWSWWWWWWWWW
WWWWWWWWWSWWWWWWWWW
WWWWWWWWWSWWWWWWWWW
WWWWWWWWWSWWWWWWWWW
W                 W
WWWWWWWWWWWWWWWWWWW